1111111111
10P00C0001
11111C0001
10001C0001
10001C0001
11111C0001
10000C0001
100CCC0001
100C000001
1000E00001
1111111111